111111111111111111111111111111111
1000P000000C000000000000000000001
100000000000000000000000000000001
100000000011111111111000000000001
100000000011111111111100000C00001
100000000011111111111111000000001
100000000111111111111111110000001
100000001111111111111110000000001
100000000011111111110000000000001
100000000001111111100000000000001
1000C0000000011110000000000000001
100000000000000100000000000000001
1000000000000000000000000000E0001
111111111111111111111111111111111
