1111111111111111111
1000000000000001111
100000C0000C0000001
1000000000000PE0001
101C000011100000001
1C10000000C00000001
1111111111111111111
