111111111111111111111111111111111
100000000000000000000000000000001
100000000000000000000000000000001
100000000011111111111000000000001
100000000011111111111100000000001
100000000011111111111111000000001
100000000111111111111111110000001
100000001111111111111110000000001
100000000011111111110000000000001
100000000001111111100000000000001
100000000000011110000000000000001
100000000000000100000000000000001
100000000000000000000000000000001
111111111111111111111111111111111
