1111111111111111111111111111111
1000P000000C0000000000000000001
1000000000000000000000000000001
1000000000111101111110000000001
100000000011110111111100000C001
1000000000111101111111110000001
10C0000001111101111111111100001
1000000011111101111111100000001
1000000000111101111100000000001
1000000000011101111000000000001
1000C00000000101000000000CE0001
1000000000000000000000000000001
1111111111111111111111111111111
