11111
10001
10P01
1CE01
11111
