1111111111111
10000000000P1
111110111111
111110111C111
1000001110111
1011111110111
1000C00000001
11111110E0111
1111111111111
