1111111111111111111
100000000000P001111
100000C0000C0000001
10000000000000E0001
100C000011100000001
1000000000C00000001
1111111111111111111
